┌─┬───────┬─────────────────┬─────────┬─────────────┬─────────┬─────┬─────┬───────────────┬─────────┬─┬───────────┬─────┬─────────┬─────────────┬─────┬─┐
│ │       │                 │         │             │         │     │     │               │         │ │           │     │         │             │     │ │
 │ ┌───┐ │ ──────────┬── ┌─┘ ┌─┐ ┌───┘ ──┐ ┌─────┐ │ ──┐ ┌─┐ └── │ │ ──┐ └─┐ │ ──┐ ┌───┐ │ │ ──┬── │ │ ──┐ ──────┘ ┌─┐ │ │ │ ┌───┤ ──┬──── ┌── ├── │ │ │
│   │   │ │           │   │   │ │ │       │ │     │ │   │ │ │     │ │   │   │ │   │ │   │ │ │   │   │ │   │         │ │   │ │ │   │   │     │   │   │ │ │
├─┬─┘ ──┘ │ ──┬─────┐ │ ┌─┤ ──┘ │ │ ┌─────┘ │ │ ┌─┘ │ ┌─┘ │ └─────┤ └─┐ └─┐ └─┤ │ └─┘ │ │ │ ├── │ ┌─┘ └─┐ └───┬─────┘ └───┤ │ │ │ ├── │ ────┤ ──┤ ──┤ │ │
│ │       │   │     │ │ │ │     │   │       │ │ │   │ │   │       │   │   │   │ │     │ │ │ │   │ │     │     │           │ │ │ │ │   │     │   │   │   │
│ │ ┌─────┴─┐ └── │ │ │ │ └───┐ ├───┤ ──┬───┘ └─┘ ┌─┴─┘ ┌─┘ ──┬─┐ └─┐ └─┐ └─┐ └─┤ ────┤ │ └─┘ ┌─┤ │ │ ──┴───┐ └─┐ ┌── ┌───┤ ├─┘ │ │ ┌─┼──── ├─┐ │ │ └───┤
│   │       │     │ │ │       │ │   │   │         │     │     │ │   │   │   │   │     │ │     │ │ │ │       │   │ │   │   │ │   │   │ │     │ │ │ │     │
│ ┌─┴── ┌───┘ ┌───┴─┘ ├──── ┌─┘ └── └─┐ │ ┌─────┬─┘ ──┬─┘ ──┐ │ ├── ├─┐ ├── ├─┐ │ ┌───┤ └───┬─┘ │ ├─┴───┐ ┌─┴── │ ├───┘ │ │ │ ──┴───┤ │ ┌───┘ │ ├─┴──── │
│ │     │     │       │     │         │ │ │     │     │     │ │ │   │ │ │   │ │ │ │   │     │     │     │ │       │     │ │         │ │ │     │ │       │
│ │ ────┤ ──┬─┘ │ ┌───┴─────┤ ┌───────┘ │ └── │ └───┐ └─┬─┐ │ │ │ ┌─┘ │ │ ┌─┘ │ └─┘ │ │ ┌── │ ────┤ ┌── │ │ ────┬─┘ ┌───┤ ├───────┐ │ │ └─┐ ──┘ │ ┌───┐ │
│ │     │   │   │ │         │ │         │     │     │   │ │ │ │ │ │   │   │   │     │ │ │   │     │ │   │       │   │   │ │       │   │   │     │ │   │ │
│ └───┐ └── │ ──┴─┘ ──┬───┐ │ │ ┌───────┴───┬─┴───┐ │ │ │ │ │ │ │ │ │ └───┘ │ └─┬───┤ └─┘ ┌─┴───┐ │ │ ──┴─┬─────┘ ┌─┘ │ │ │ ┌───┐ └───┴── │ ────┤ │ │ │ │
│     │     │         │   │   │ │           │     │ │ │ │ │ │ │ │   │       │   │   │     │     │   │     │       │   │ │   │   │         │     │   │ │ │
├───┐ ├───┐ └───┬───┬─┘ │ └─┐ │ └─┬───┐ ────┘ │ ──┘ └─┘ │ │ │ │ └─┬─┴───┬── ├───┤ │ └───┬─┘ ┌─┐ └───┴─┬── │ ┌───┬─┘ │ └─┴───┘ │ ├───┬─────┼──── │ ┌─┤ └─┘
│   │ │   │     │   │   │   │ │   │   │       │         │   │ │   │     │   │   │ │     │   │ │       │   │ │   │   │         │ │   │     │     │ │ │   ⇨
├── │ │ │ ├───┐ └── │ ┌─┼── │ ├── │ │ └───┬───┴─────┬───┘ ┌─┤ ├── │ │ ──┤ ┌─┤ │ │ └─┐ │ │ ┌─┘ └───┐ ──┤ ──┘ │ │ │ ┌─┼──── ┌───┤ │ │ │ │ ──┘ ┌───┤ │ └─┐ │
│   │   │ │   │     │ │ │   │ │   │ │     │         │     │ │ │   │ │   │ │ │ │ │   │ │ │ │       │   │     │ │   │ │     │   │ │ │   │     │   │ │   │ │
│ ──┴─┬─┘ │ ──┴── ┌─┘ │ │ ──┤ │ ┌─┘ ├───┐ │ ┌─────┐ │ ┌───┘ │ │ │ │ └─┐ │ │ │ │ └─┐ │ └─┤ │ │ ┌── └─┐ └─────┘ ├───┘ │ │ ┌─┘ │ ├─┘ ├───┴───┬─┘ │ │ │ ┌─┘ │
│     │   │       │   │     │ │ │   │   │   │     │ │ │     │ │ │ │   │     │ │   │ │   │ │ │ │     │         │     │ │ │   │ │   │       │   │ │ │ │   │
│ │ ──┘ ┌─┴─┐ ┌───┤ ──┴─┬── └─┤ │ ┌─┘ │ └───┴─┐ │ │ │ │ ┌───┘ │ └─┘ ┌─┴─────┘ │ │ │ ├─┐ │ │ │ └─────┴───┬─────┘ ┌─┐ │ └─┤ ┌─┘ │ ──┴──── │ └───┤ │ │ │ │ │
⇨ │     │   │ │   │     │     │ │ │   │       │ │ │ │   │     │     │         │ │ │ │ │   │ │           │       │ │ │   │ │   │         │     │ │ │ │ │ │
│ ├─────┘ │ │ │ ──┴───┐ └───┐ │ │ └─┐ ├───┐ │ │ └─┤ └───┤ ────┴─┐ ┌─┘ ┌───┬───┤ └─┤ │ ├───┤ └───────┐ │ └─┐ ────┘ │ └─┐ │ │ │ └─┬───────┼──── │ │ │ │ │ │
│ │       │ │ │       │     │ │ │   │ │   │ │ │   │     │       │ │   │   │   │   │   │   │         │ │   │       │   │ │ │ │   │       │     │   │ │ │ │
│ └──── ┌─┘ │ │ │ ┌───┤ ──┐ │ │ ├── │ │ │ │ │ ├── ├───┐ │ ┌───┐ │ │ ┌─┘ │ │ │ └─┐ └── │ │ └───┬── ┌─┘ ├─┐ └───────┴── │ │ │ ├── │ │ │ ┌─┘ ┌───┘ ──┘ │ │ │
│       │   │ │ │ │   │   │ │   │   │ │ │   │ │   │   │ │ │   │ │ │ │   │   │   │     │ │     │   │   │ │             │   │ │   │ │ │ │   │         │ │ │
├───┬───┘ ┌─┘ ├─┘ │ │ ├───┤ └─┐ │ ┌─┘ │ ├───┤ │ ┌─┘ │ │ │ │ │ │ └─┤ └───┴─┐ │ ┌─┴───┬─┴─┘ ┌── │ ┌─┘ ┌─┘ └───────┬───┐ ├───┤ └─┐ │ │ │ │ ──┼─────────┘ │ │
│   │     │   │   │ │ │   │   │ │ │   │ │   │   │   │   │ │ │ │   │       │ │ │     │     │   │ │   │           │   │ │   │   │ │ │ │ │   │           │ │
│ │ │ ────┤ ──┤ ──┤ │ │ │ │ │ │ │ │ ──┤ ├── └─┐ │ ┌─┴───┤ │ │ ├─┐ └─────┐ └─┤ │ │ ──┘ │ ──┴───┤ │ ──┤ ──┬── ┌── │ │ │ │ ──┴─┐ └─┘ │ └─┴── │ ──────────┴─┤
│ │ │     │   │   │ │   │ │ │ │ │ │   │ │     │ │ │     │ │ │ │ │       │   │   │     │       │ │   │   │   │   │ │   │     │     │       │             │
│ └─┴───┐ ├── └── │ └─┬─┤ └─┤ └─┘ └───┘ │ │ ┌─┘ │ ├── │ │ │ │ │ │ ────┐ └─┐ ├───┼─────┤ ────┐ │ ├── ├───┘ ┌─┘ ┌─┘ ├───┴─┐ ──┴─────┴─────┬─┤ ┌───┬───┬─┐ │
│       │ │       │   │ │   │           │ │ │   │ │   │ │ │ │   │     │   │ │   │     │     │   │   │     │   │   │     │               │ │ │   │   │ │ │
│ │ ────┘ │ ┌───┐ ├── │ └─┐ │ ┌───┬─────┤ └─┘ ──┤ │ ┌─┘ │ │ └─┐ └─┬─┐ └───┤ │ │ │ ──┐ │ ┌───┼───┤ ┌─┘ ──┬─┘ ──┤ ┌─┘ ┌─┐ │ │ ┌─────┬──── │ │ │ │ │ │ │ │ │
│ │       │ │   │ │   │   │ │ │   │     │       │ │ │   │ │   │   │ │     │ │ │ │   │ │ │   │   │ │     │     │ │   │ │ │ │ │     │     │     │   │   │ │
│ └───────┴─┘ │ └─┘ ┌─┘ ──┘ └─┘ │ │ ┌── └───────┘ │ └───┘ └── ├── │ └───┐ │ │ │ └── │ └─┘ │ │ │ │ │ ──┐ └─────┘ │ ┌─┘ │ └─┘ │ ──┐ │ ────┴─────┴───┴───┘ │
│             │     │           │   │             │           │         │     │     │     │   │   │   │           │         │   │                       │
└─────────────┴─────┴───────────┴───┴─────────────┴───────────┴─────────┴─────┴─────┴─────┴───┴───┴───┴───────────┴─────────┴───┴───────────────────────┘
